XXXXXXXXXXXXXXX
X             X
X XXXXXXXXXXX X
X X         X X
X XXXXXXXXX X X
X XXXXXXXXX X X
X XXXX    S X X
X XXXX XXXX X X
X XXXX XXXX X X
X X    XXXXXX X
X X XXXXXXXXX X
X X XXXXXXXXX X
X X         X X
X XXXXXXXXX   F
XXXXXXXXXXXXXXX